insert into bookmaker values(1,	trim('Pinnacle                                                 '), 'INACTIVE');
insert into bookmaker values(2,	trim('Betcity                                                  '), 'INACTIVE');
insert into bookmaker values(3,	trim('Sbobet                                                   '), 'INACTIVE');
insert into bookmaker values(4,	trim('Marathon                                                 '), 'INACTIVE');
insert into bookmaker values(5,	trim('188bet                                                   '), 'INACTIVE');
insert into bookmaker values(6,	trim('Fonbet                                                   '), 'INACTIVE');
insert into bookmaker values(7,	trim('LSBet                                                    '), 'INACTIVE');
insert into bookmaker values(9,	trim('Bwin                                                     '), 'INACTIVE');
insert into bookmaker values(10,	trim('Bet365                                                   '), 'INACTIVE');
insert into bookmaker values(11,	trim('Betfair                                                  '), 'INACTIVE');
insert into bookmaker values(12,	trim('DafabetOW                                                '), 'INACTIVE');
insert into bookmaker values(13,	trim('WilliamHill                                              '), 'INACTIVE');
insert into bookmaker values(14,	trim('Betclic                                                  '), 'INACTIVE');
insert into bookmaker values(17,	trim('PariMatch                                                '), 'INACTIVE');
insert into bookmaker values(19,	trim('Unibet                                                   '), 'INACTIVE');
insert into bookmaker values(20,	trim('DafaSports                                               '), 'INACTIVE');
insert into bookmaker values(21,	trim('1xbet                                                    '), 'INACTIVE');
insert into bookmaker values(22,	trim('Favbet                                                   '), 'INACTIVE');
insert into bookmaker values(23,	trim('BetAtHome                                                '), 'INACTIVE');
insert into bookmaker values(24,	trim('10bet                                                    '), 'INACTIVE');
insert into bookmaker values(26,	trim('Totogaming                                               '), 'INACTIVE');
insert into bookmaker values(27,	trim('Olimp                                                    '), 'INACTIVE');
insert into bookmaker values(28,	trim('Retabet                                                  '), 'INACTIVE');
insert into bookmaker values(29,	trim('Tipico                                                   '), 'INACTIVE');
insert into bookmaker values(30,	trim('Leon                                                     '), 'INACTIVE');
insert into bookmaker values(31,	trim('Matchbook                                                '), 'INACTIVE');
insert into bookmaker values(32,	trim('Ladbrokes                                                '), 'INACTIVE');
insert into bookmaker values(34,	trim('Vbet                                                     '), 'INACTIVE');
insert into bookmaker values(37,	trim('GGBet                                                    '), 'INACTIVE');
insert into bookmaker values(38,	trim('Betdaq                                                   '), 'INACTIVE');
insert into bookmaker values(39,	trim('Tipsport                                                 '), 'INACTIVE');
insert into bookmaker values(41,	trim('Rivalo                                                   '), 'INACTIVE');
insert into bookmaker values(42,	trim('SportpesaIT                                              '), 'INACTIVE');
insert into bookmaker values(43,	trim('Betflag                                                  '), 'INACTIVE');
insert into bookmaker values(46,	trim('BookMaker                                                '), 'INACTIVE');
insert into bookmaker values(48,	trim('Betsson                                                  '), 'INACTIVE');
insert into bookmaker values(50,	trim('Smarkets                                                 '), 'INACTIVE');
insert into bookmaker values(52,	trim('Boylesports                                              '), 'INACTIVE');
insert into bookmaker values(53,	trim('PaddyPower                                               '), 'INACTIVE');
insert into bookmaker values(54,	trim('PlanetWin365                                             '), 'INACTIVE');
insert into bookmaker values(55,	trim('Betshop                                                  '), 'INACTIVE');
insert into bookmaker values(56,	trim('BetOnline                                                '), 'INACTIVE');
insert into bookmaker values(57,	trim('Cashpoint                                                '), 'INACTIVE');
insert into bookmaker values(60,	trim('Interwetten                                              '), 'INACTIVE');
insert into bookmaker values(61,	trim('Goldenpalace                                             '), 'INACTIVE');
insert into bookmaker values(63,	trim('Goalbet                                                  '), 'INACTIVE');
insert into bookmaker values(65,	trim('Betvictor                                                '), 'INACTIVE');
insert into bookmaker values(68,	trim('BetTopsport                                              '), 'INACTIVE');
insert into bookmaker values(70,	trim('Superbet                                                 '), 'INACTIVE');
insert into bookmaker values(73,	trim('Bodog                                                    '), 'INACTIVE');
insert into bookmaker values(74,	trim('TonyBet                                                  '), 'INACTIVE');
insert into bookmaker values(75,	trim('Efbet                                                    '), 'INACTIVE');
insert into bookmaker values(76,	trim('Stoiximan                                                '), 'INACTIVE');
insert into bookmaker values(78,	trim('Betway                                                   '), 'INACTIVE');
insert into bookmaker values(79,	trim('BFSportsbook                                             '), 'INACTIVE');
insert into bookmaker values(80,	trim('Fortuna                                                  '), 'INACTIVE');
insert into bookmaker values(81,	trim('Kladise                                                  '), 'INACTIVE');
insert into bookmaker values(83,	trim('Novibet                                                  '), 'INACTIVE');
insert into bookmaker values(85,	trim('Wplay                                                    '), 'INACTIVE');
insert into bookmaker values(86,	trim('Skybet                                                   '), 'INACTIVE');
insert into bookmaker values(87,	trim('STS                                                      '), 'INACTIVE');
insert into bookmaker values(90,	trim('testbookmaker90                                          '), 'INACTIVE');
insert into bookmaker values(92,	trim('Cloudbet                                                 '), 'INACTIVE');
insert into bookmaker values(94,	trim('Pamestoixima                                             '), 'INACTIVE');
insert into bookmaker values(95,	trim('888Sport                                                 '), 'INACTIVE');
insert into bookmaker values(97,	trim('Kirolbet                                                 '), 'INACTIVE');
insert into bookmaker values(99,	trim('Pokerstars                                               '), 'INACTIVE');
insert into bookmaker values(100,	trim('Codere                                                   '), 'INACTIVE');
insert into bookmaker values(102,	trim('Snai                                                     '), 'INACTIVE');
insert into bookmaker values(103,	trim('Sisal                                                    '), 'INACTIVE');
insert into bookmaker values(105,	trim('Sportmarket                                              '), 'INACTIVE');
insert into bookmaker values(106,	trim('Eurobet                                                  '), 'INACTIVE');
insert into bookmaker values(109,	trim('Goldbetshop                                              '), 'INACTIVE');
insert into bookmaker values(119,	trim('BetinAsia                                                '), 'INACTIVE');
insert into bookmaker values(127,	trim('FortuneJack                                              '), 'INACTIVE');
insert into bookmaker values(128,	trim('Meridianbet                                              '), 'INACTIVE');
insert into bookmaker values(129,	trim('Betaland                                                 '), 'INACTIVE');
insert into bookmaker values(131,	trim('Sportsbet                                                '), 'INACTIVE');
insert into bookmaker values(142,	trim('TonybetUk                                                '), 'INACTIVE');
insert into bookmaker values(143,	trim('NetbetGr                                                 '), 'INACTIVE');
insert into bookmaker values(145,	trim('Mozzartbet                                               '), 'INACTIVE');
insert into bookmaker values(148,	trim('FanDuel                                                  '), 'INACTIVE');
insert into bookmaker values(150,	trim('DraftKings                                               '), 'INACTIVE');
insert into bookmaker values(152,	trim('Raybet                                                   '), 'INACTIVE');
insert into bookmaker values(157,	trim('NitroBetting                                             '), 'INACTIVE');
insert into bookmaker values(161,	trim('Karamba                                                  '), 'INACTIVE');
insert into bookmaker values(162,	trim('Yajuego                                                  '), 'INACTIVE');
insert into bookmaker values(163,	trim('Eplay24                                                  '), 'INACTIVE');
insert into bookmaker values(164,	trim('UnibetBE                                                 '), 'INACTIVE');
insert into bookmaker values(167,	trim('Netbet                                                   '), 'INACTIVE');
insert into bookmaker values(169,	trim('Bet365 (reserve)                                         '), 'INACTIVE');
insert into bookmaker values(187,	trim('AdmiralBetIt                                             '), 'INACTIVE');
insert into bookmaker values(188,	trim('Stake                                                    '), 'INACTIVE');
insert into bookmaker values(189,	trim('BetRadar                                                 '), 'INACTIVE');
insert into bookmaker values(190,	trim('Sportium                                                 '), 'INACTIVE');
insert into bookmaker values(191,	trim('Luckia                                                   '), 'INACTIVE');
insert into bookmaker values(194,	trim('BetclicIt                                                '), 'INACTIVE');
insert into bookmaker values(196,	trim('Winbet                                                   '), 'INACTIVE');
insert into bookmaker values(197,	trim('StanleybetRo                                             '), 'INACTIVE');
insert into bookmaker values(198,	trim('BetAtHomeCom                                             '), 'INACTIVE');
insert into bookmaker values(200,	trim('Avgline                                                  '), 'INACTIVE');
insert into bookmaker values(252,	trim('Magnumbet                                                '), 'INACTIVE');
insert into bookmaker values(255,	trim('Neobet                                                   '), 'INACTIVE');
insert into bookmaker values(270,	trim('EverymatrixBet365                                        '), 'INACTIVE');
insert into bookmaker values(278,	trim('StanleybetIt                                             '), 'INACTIVE');
insert into bookmaker values(279,	trim('Winamax                                                  '), 'INACTIVE');
insert into bookmaker values(290,	trim('Playnow                                                  '), 'INACTIVE');
insert into bookmaker values(291,	trim('Pixbet                                                   '), 'INACTIVE');
insert into bookmaker values(293,	trim('StanleybetBe                                             '), 'INACTIVE');
insert into bookmaker values(294,	trim('Mansion88                                                '), 'INACTIVE');
insert into bookmaker values(297,	trim('BeticIt                                                  '), 'INACTIVE');
insert into bookmaker values(301,	trim('CasinoBarcelona                                          '), 'INACTIVE');
insert into bookmaker values(304,	trim('Jokerbet                                                 '), 'INACTIVE');
insert into bookmaker values(305,	trim('Versus                                                   '), 'INACTIVE');
insert into bookmaker values(308,	trim('Sazka                                                    '), 'INACTIVE');
insert into bookmaker values(311,	trim('Synottip                                                 '), 'INACTIVE');
insert into bookmaker values(312,	trim('GWBet                                                    '), 'INACTIVE');
insert into bookmaker values(313,	trim('DaznBet                                                  '), 'INACTIVE');
insert into bookmaker values(314,	trim('Iforbet                                                  '), 'INACTIVE');
insert into bookmaker values(315,	trim('MarathonES                                               '), 'INACTIVE');
insert into bookmaker values(316,	trim('Mansion88Asia                                            '), 'INACTIVE');
insert into bookmaker values(317,	trim('BetfairES                                                '), 'INACTIVE');
insert into bookmaker values(318,	trim('Lvbet                                                    '), 'INACTIVE');
insert into bookmaker values(319,	trim('Virginbet                                                '), 'INACTIVE');
insert into bookmaker values(320,	trim('1xbetES                                                  '), 'INACTIVE');
insert into bookmaker values(321,	trim('BetwayES                                                 '), 'INACTIVE');