insert into sport values(1	, trim('Baseball                                    '));
insert into sport values(2	, trim('Basketball                                  '));
insert into sport values(4	, trim('Futsal                                      '));
insert into sport values(5	, trim('Handball                                    '));
insert into sport values(6	, trim('Hockey                                      '));
insert into sport values(7	, trim('Soccer                                      '));
insert into sport values(8	, trim('Tennis                                      '));
insert into sport values(9	, trim('Volleyball                                  '));
insert into sport values(10	, trim('Am. Football                                '));
insert into sport values(11	, trim('Snooker                                     '));
insert into sport values(12	, trim('Darts                                       '));
insert into sport values(13	, trim('Table Tennis                                '));
insert into sport values(14	, trim('Badminton                                   '));
insert into sport values(15	, trim('Rugby League                                '));
insert into sport values(16	, trim('Water Polo                                  '));
insert into sport values(17	, trim('Bandy                                       '));
insert into sport values(18	, trim('Martial arts                                '));
insert into sport values(19	, trim('Field Hockey                                '));
insert into sport values(20	, trim('AFL                                         '));
insert into sport values(21	, trim('Other E-Sports                              '));
insert into sport values(22	, trim('Chess                                       '));
insert into sport values(23	, trim('Gaelic Sport                                '));
insert into sport values(24	, trim('Cricket                                     '));
insert into sport values(25	, trim('Formula 1                                   '));
insert into sport values(27	, trim('Motorsport                                  '));
insert into sport values(28	, trim('Cycling                                     '));
insert into sport values(29	, trim('Beach Volley                                '));
insert into sport values(30	, trim('Horse Racing                                '));
insert into sport values(31	, trim('Biathlon                                    '));
insert into sport values(32	, trim('Curling                                     '));
insert into sport values(33	, trim('Squash                                      '));
insert into sport values(34	, trim('Netball                                     '));
insert into sport values(35	, trim('Beach Soccer                                '));
insert into sport values(36	, trim('Floorball                                   '));
insert into sport values(37	, trim('Hurling                                     '));
insert into sport values(38	, trim('Kung Volleyball                             '));
insert into sport values(39	, trim('E-Soccer                                    '));
insert into sport values(41	, trim('E-Basketball                                '));
insert into sport values(43	, trim('Rugby Union                                 '));
insert into sport values(44	, trim('Boxing                                      '));
insert into sport values(45	, trim('MMA                                         '));
insert into sport values(46	, trim('Dota 2                                      '));
insert into sport values(47	, trim('Counter-Strike                              '));
insert into sport values(48	, trim('League of Legends                           '));
insert into sport values(49	, trim('Golf                                        '));
insert into sport values(50	, trim('Lacrosse                                    '));